000000000000010
011111111111110
010000000000000
011111111111110
000000000000010
000000000000010
011111111111110
010000000000000
011111111111111
000000000000000

000000000000010
044444444444410
010000000000000
013333333333330 
000000000000010
000000000000010 
044444444444410
010000000000000 
013333333333333
000000000000000